111111111111111111111111111111
100111110011000100000100001111
110P00000001110100100001100011
110111011000010000001C01001011
110000000000010010111001101001
101111011111010010001110101111
1010000000N0011011100000100011
111001111111001000111110111001
100111000000000110000100011111
110101010111110001011110100101
11010111C10100N000000100110101
110100001101011110001100100111
100100111001111000111001100011
110111000000000101000001011111
110101011111110110100000101001
111101000100010000010001001001
10100111011101111001C111011001
101110000000000001010010010011
1110100C1011001000011111111111
100010000100111001001000000011
111001110111001101011011110001
101011100010011110011010110001
111010110110010011001000011101
110010000101111100000011010111
111011011101E00C01110000000001
111111111111111111111111111111